##################################################
#####.....#.......#...#...#...........#.....######
#####.#.###.#####.#.#.#.#.#.#####.###.#.#.#.######
#####.#.....#...#.#.#...#.......#.#...#.#.#.######
#####.#######.###.#.#############.#.#####.#.######
#####...#.....#...#.......#.......#.......#.######
#######.###.###.#########.#.###############.######
#####O#.....#...#...#.....#...#.#.........#.######
#####.#####.#.###.#.#.#######.#.#.#####.###.######
#####.#.....#...#.#.........#.#.#.#...#.#...######
#####.#.#####.#.#.#####.#####.#.#.#.#.#.#.########
#####...#...#.#...#...#.#.....#.#.#.#.#.#.#.######
#####.###.#.#######.#.###.#####.#.#.#.#.#.#.######
#####.#...#.........#...#.#.......#.#.#.#.#.######
#######.###############.#.#.#######.#.#.#.#.######
#####...#.................#.#.#.....#...#.#.######
#####.###.#################.#.#.#########.#.######
#####...#.#.............#.....#.#.........#.######
#######.###.###########.#######.#.#########.######
#####...#...#.......#.#...#...#.#.....#.....######
#####.###.###.#####.#.###.#.#.#.#####.#.###.######
#####.#...#...#...#...#.#s#.#.#.#.....#.#.#.######
#####.#.#####.#.#.###.#.###.#.#.#.#####.#.#.######
#####.#.#.....#.#.#...#...#.#.#.#.#.....#...######
#####.#.###.###.#.#.###.#.#.#.#.#.#####.#.########
#####.#.#...#.#.#...#...#...#.#.#.....#.#...######
#####.#.#.###.#.#####.#######.#.#####.#.###.######
#####...#.#...#.#.....#.......#.....#...#...######
#########.#.###.#.#####.###########.#####.########
#####.....#...#.#.#.....................#...######
#####.###.#.#.#.#.#######.#####.#######.###.######
#####.#...#.#...#.......#.#...#.#...#.....#.######
#####.#.###.#########.#.#.#.#.###.#.#.#####.######
#####.#.#...........#.#.#.#.#.....#.#.#.....######
#######.###########.###.###.#######.###.##########
#####...#.....#...#.....#...#.#.....#...#...######
#####.###.###.#.#.#####.#.###.#.###.#.###.#.######
#####.....#...#.#.#...#.#.....#.#...#...#.#.######
#####.#####.###.#.#.#.#######.#.#######.###.######
#####.....#.....#...#.........#.............######
##################################################
